#######
##@--##
#--#--#
#-$*$-#
#--.--#
##-.-##
#######