#######
#@----#
#--.$-#
#---###
#--$--#
#---#.#
#######