########
#@-----#
#----###
#-$-#--#
#---#-$#
#-.-#-.#
########