#######
#@----#
#---..#
#--#$$#
#--#--#
#--#--#
#######