##########
###----###
###------#
###-$$##-#
#..*@----#
#..*-#$-##
####-#-$-#
####-----#
##########