###################
#####---###########
#####--$###########
#####---###########
###------##########
###-#-##-##########
#---#-##-#####--**#
#--------------@**#
#####-###-#-##--.*#
#####-----#########
###################