###################
#####---###########
#####$--###########
#####--$###########
###--$-$-##########
###-#-##-##########
#---#-##-#####--..#
#-$--$----------..#
#####-###-#@##--..#
#####-----#########
###################