#######
#@---##
#-$$--#
#-#.-.#
#-----#
#######