###########
#------####
#--#---.###
#-$-----###
#--@#---###
###----*###
#####-----#
#######---#
#######---#
###########